101 100
S...................................................................................................
###################################################################################################.
....................................................................................................
.###################################################################################################
....................................................................................................
###################################################################################################.
....................................................................................................
.###################################################################################################
....................................................................................................
###################################################################################################.
....................................................................................................
.###################################################################################################
....................................................................................................
###################################################################################################.
....................................................................................................
.###################################################################################################
....................................................................................................
###################################################################################################.
....................................................................................................
.###################################################################################################
....................................................................................................
###################################################################################################.
....................................................................................................
.###################################################################################################
....................................................................................................
###################################################################################################.
....................................................................................................
.###################################################################################################
....................................................................................................
###################################################################################################.
....................................................................................................
.###################################################################################################
....................................................................................................
###################################################################################################.
....................................................................................................
.###################################################################################################
....................................................................................................
###################################################################################################.
....................................................................................................
.###################################################################################################
....................................................................................................
###################################################################################################.
....................................................................................................
.###################################################################################################
....................................................................................................
###################################################################################################.
....................................................................................................
.###################################################################################################
....................................................................................................
###################################################################################################.
....................................................................................................
.###################################################################################################
....................................................................................................
###################################################################################################.
....................................................................................................
.###################################################################################################
....................................................................................................
###################################################################################################.
....................................................................................................
.###################################################################################################
....................................................................................................
###################################################################################################.
....................................................................................................
.###################################################################################################
....................................................................................................
###################################################################################################.
....................................................................................................
.###################################################################################################
....................................................................................................
###################################################################################################.
....................................................................................................
.###################################################################################################
....................................................................................................
###################################################################################################.
....................................................................................................
.###################################################################################################
....................................................................................................
###################################################################################################.
....................................................................................................
.###################################################################################################
....................................................................................................
###################################################################################################.
....................................................................................................
.###################################################################################################
....................................................................................................
###################################################################################################.
....................................................................................................
.###################################################################################################
....................................................................................................
###################################################################################################.
....................................................................................................
.###################################################################################################
....................................................................................................
###################################################################################################.
....................................................................................................
.###################################################################################################
....................................................................................................
###################################################################################################.
....................................................................................................
.###################################################################################################
...................................................................................................F
